1
....#####.............
....#...#.............
....#$..#.............
..###..$###...........
..#..$..$.#...........
###.#.###.#.....######
#...#.###.#######..OO#
#.$..$.............OO#
#####.####.#@####..OO#
....#......###..######
....########..........
2
############..
#OO..#.....###
#OO..#.$..$..#
#OO..#$####..#
#OO....@.##..#
#OO..#.#..$.##
######.##$.$.#
..#.$..$.$.$.#
..#....#.....#
..############
e